[
[5, 5, 5, 5, 5, 5, 5, 5, 5, 5, 5, 5, 5, 5, 5, 5, 5, 5, 5, 5, 5, 5, 5, 5, 5, 5, 5, 5, 5, 5, 5, 5, 5, 5, 5, 5, 5, 5, 5, 5, 5],
[5, 5, 5, 5, 5, 5, 5, 5, 5, 5, 5, 5, 5, 5, 5, 5, 5, 5, 5, 5, 5, 5, 5, 5, 5, 5, 5, 5, 5, 5, 5, 5, 5, 5, 5, 5, 5, 5, 5, 5, 5],
[5, 5, 5, 5, 5, 5, 5, 5, 5, 5, 5, 5, 5, 5, 5, 5, 5, 5, 5, 5, 5, 5, 5, 5, 5, 5, 5, 5, 5, 5, 5, 5, 5, 5, 5, 5, 5, 5, 5, 5, 5],
[5, 5, 5, 5, 5, 5, 5, 5, 5, 5, 5, 5, 5, 5, 5, 5, 5, 5, 5, 5, 5, 5, 5, 5, 5, 5, 5, 5, 5, 5, 5, 5, 5, 5, 5, 5, 5, 5, 5, 5, 5],
[5, 5, 5, 5, 5, 5, 5, 5, 5, 5, 5, 5, 5, 5, 5, 5, 5, 5, 5, 5, 5, 5, 5, 5, 5, 5, 5, 5, 5, 5, 5, 5, 5, 5, 5, 5, 5, 5, 5, 5, 5],
[5, 5, 5, 5, 5, 5, 5, 5, 5, 5, 5, 5, 5, 5, 5, 5, 5, 5, 5, 5, 5, 5, 5, 5, 5, 5, 5, 5, 5, 5, 5, 5, 5, 5, 5, 5, 5, 5, 5, 5, 5],
[5, 5, 5, 5, 5, 5,11, 8, 8, 8, 8,13, 5,11, 8, 8, 8, 8,13, 5, 5, 5, 5, 5, 5, 5,11, 8, 8, 8, 8, 8, 8,13, 5, 5, 5, 5, 5, 5, 5],
[5, 5, 5, 5, 5, 5, 6, 0, 0, 0, 0, 7, 8, 9, 0, 0,25, 0, 7, 8,13, 5, 5, 5, 5, 5, 6, 0, 0, 0,25, 0, 0, 7,13, 5, 5, 5, 5, 5, 5],
[5, 5, 5, 5, 5, 5, 6, 0, 0, 0, 0, 0,25, 0, 0, 0, 0, 0, 0, 0, 7, 8,13, 5,11, 8, 9, 0, 0, 0, 0, 0,82, 0, 4, 5, 5, 5, 5, 5, 5],
[5, 5, 5, 5, 5, 5, 6,22, 0,21, 0, 0, 0, 0,51, 0, 0, 0, 0, 0, 0, 0, 4,11, 9, 0, 0, 0, 0, 0, 0, 0, 0, 0, 4, 5, 5, 5, 5, 5, 5],
[5, 5, 5, 5, 5, 5,17, 2, 2, 3, 0,23, 0,52, 1, 2, 3, 0, 0, 0, 0, 0, 4, 6, 0, 0,52, 0, 0,51, 0,21, 1, 2,19, 5, 5, 5, 5, 5, 5],
[5, 5, 5, 5, 5, 5, 5, 5, 5,17, 2, 3, 0, 0, 0, 0, 0,51, 0,83, 0, 0, 4, 6, 0, 0, 0, 0, 0, 1, 2, 2,19, 5, 5, 5, 5, 5, 5, 5, 5],
[5, 5, 5, 5, 5, 5,11, 8, 8, 8, 8, 9, 0, 0, 0, 0, 0, 1, 2, 3, 0, 0, 4, 6, 0, 0, 0, 0, 0, 4, 5, 5, 5, 5, 5, 5, 5, 5, 5, 5, 5],
[5, 5, 5, 5, 5, 5, 6,81, 0, 0, 0, 0, 0, 0,51, 0,22, 4, 5,17, 3, 0, 7, 9, 0, 0, 0, 1, 2,19, 5, 5, 5, 5, 5, 5, 5, 5, 5, 5, 5],
[5, 5, 5, 5, 5, 5,17, 3, 0, 0, 0, 0, 0,23, 1, 2, 2,19, 5, 5, 6,51, 0, 0,22, 0, 1,19, 5, 5, 5, 5, 5, 5, 5, 5, 5, 5, 5, 5, 5],
[5, 5, 5, 5, 5, 5, 5,17, 2, 3,51,22, 0, 1,19, 5, 5, 5, 5, 5,17, 2, 2, 2, 2, 2,19, 5, 5, 5, 5, 5, 5, 5, 5, 5, 5, 5, 5, 5, 5],
[5, 5, 5, 5, 5, 5, 5, 5, 5,17, 2, 2, 2,19, 5, 5, 5, 5, 5, 5, 5, 5, 5, 5, 5, 5, 5, 5, 5, 5, 5, 5, 5, 5, 5, 5, 5, 5, 5, 5, 5],
[5, 5, 5, 5, 5, 5, 5, 5, 5, 5, 5, 5, 5, 5, 5, 5, 5, 5, 5, 5, 5, 5, 5, 5, 5, 5, 5, 5, 5, 5, 5, 5, 5, 5, 5, 5, 5, 5, 5, 5, 5],
[5, 5, 5, 5, 5, 5, 5, 5, 5, 5, 5, 5, 5, 5, 5, 5, 5, 5, 5, 5, 5, 5, 5, 5, 5, 5, 5, 5, 5, 5, 5, 5, 5, 5, 5, 5, 5, 5, 5, 5, 5],
[5, 5, 5, 5, 5, 5, 5, 5, 5, 5, 5, 5, 5, 5, 5, 5, 5, 5, 5, 5, 5, 5, 5, 5, 5, 5, 5, 5, 5, 5, 5, 5, 5, 5, 5, 5, 5, 5, 5, 5, 5],
[5, 5, 5, 5, 5, 5, 5, 5, 5, 5, 5, 5, 5, 5, 5, 5, 5, 5, 5, 5, 5, 5, 5, 5, 5, 5, 5, 5, 5, 5, 5, 5, 5, 5, 5, 5, 5, 5, 5, 5, 5],
[5, 5, 5, 5, 5, 5, 5, 5, 5, 5, 5, 5, 5, 5, 5, 5, 5, 5, 5, 5, 5, 5, 5, 5, 5, 5, 5, 5, 5, 5, 5, 5, 5, 5, 5, 5, 5, 5, 5, 5, 5],
[5, 5, 5, 5, 5, 5, 5, 5, 5, 5, 5, 5, 5, 5, 5, 5, 5, 5, 5, 5, 5, 5, 5, 5, 5, 5, 5, 5, 5, 5, 5, 5, 5, 5, 5, 5, 5, 5, 5, 5, 5],
]

Full block 1-9
Hollow block 11-19
Doodads 21-24
Enemies 51-53
Objects 81-83